0	0	0	0	0	0	0	0
0	0	6	1	1	2	1	0
0	1	2	0	1	3	1	0
0	0	3	2	2	0	0	0
0	0	4	5	3	1	1	0
0	0	1	3	1	0	0	0
0	0	0	0	0	0	0	0